1111111111111111111111111111111111
1100000000000000000000000000000001
100000000000000C000111000000000001
1010010100100000101001000000011101
1010010010101010000C01001111100001
1P0000000C00C00000100100EC001000C1
1111111111111111111111111111111111