1111111111111111111111111111111111
1E000N000000000C00000C0000N0000001
1010010100100000101001000000010101
1010010010101010001001000000010101
1P000000N100C0000000N00000000000C1
1111111111111111111111111111111111