1111111111111111111111111111111111111
1000000000000000000000000000000000001
10001100100000000C111111C0000000000P1
1000111010000000001000000000000000001
1000101110000N0000111111C000000000001
100010011E0000000N10000000000000000C1
1000000000000000001111110000000000001
1000000000000000000000000000000000001
1111111111111111111111111111111111111