1111111111111111111111111111111111
100000001000000000000C0000000000C1
1010011000100000111011000000011101
1011110010111110001001000000011101
10000000000N0000000000E00000000001
1000000N00000000011000011000000001
1C0000110000110C0000000110000000P1
1111111111111111111111111111111111