1111111111111
10010000000C1
1000011111111
1P00110001E01
1111111111111